1111001111
1P00000C00
1000000000
10000C00E1
1111100000