1111111111
1P00000C01
1000000001
10E00C00E1
1111111111