1111111111
1P00000C01
1000000001
10000C00E1
11111