1111111111111111111
100000C00C0000000C1
1P00000C00100000001
1000C10000000100001
1110000C00C00001001
1000C0000C000001001
10000000C0000C010E1
1111111111111111111