1111111111
1P00000C01
100000L001
10000C00E1
1111111111