111111111111111111111111111111
1E000000C00000C000000C00000001
1010010100100001010010C0010101
101001001010101001010000010101
1P0000000C00C000000000000000C1
111111111111111111111111111111