1111111111111111111111111111111
1E0000000000000C00000C000000001
10100101001000001010010000001C1
10100100101010100010010000001C1
1P0000000C00C000000000000000001
1111111111111111111111111111111