1111111111
1PP0000C01
1000000001
10000C00E1
1111111111